{
  "stuct": [
    [ 1,0,1,0,1,0,1,0,1,0,1,0,1,0,0 ],
    [ 1,0,0,0,1,0,1,0,1,0,1,0,1,0,0 ],
    [ 0,0,0,0,0,0,0,0,1,0,0,0,0,0,0 ],
    [ 0,0,0,0,0,0,0,0,0,0,0,0,0,0,0 ],
    [ 0,0,0,0,0,0,0,0,0,0,0,0,0,0,0 ],
    [ 1,6,1,1,1,6,6,6,6,6,1,1,1,6,10 ],
    [ 1,1,1,6,1,6,1,1,1,6,1,6,1,6,10 ],
    [ 6,6,6,6,1,6,1,6,1,1,1,6,1,1,10 ],
    [ 6,6,6,6,1,1,1,6,6,6,6,6,6,6,10 ],
    [ 0,0,0,0,0,0,0,0,0,0,0,0,0,0,0 ],
    [ 0,0,0,0,0,0,0,0,0,0,0,0,0,0,0 ],
    [ 0,0,1,0,1,0,0,0,0,0,0,0,0,0,0 ],
    [ 0,0,1,0,1,0,1,0,0,0,0,0,1,0,0 ],
    [ 1,0,1,0,1,0,1,0,1,0,1,0,1,0,0 ]
  ]
}